{
  "map_id": "demo_plains",
  "name": "平原试炼",
  "description": "初始教学关卡",
  "difficulty": 1,
  "grid_width": 20,
  "grid_height": 12,
  "cell_size": [64, 64],
  "tile_state_map": {
    "0": "empty",
    "1": "buildable",
    "3": "path"
  },
  "available_towers": ["arrow_tower", "cannon_tower", "ice_tower"],
  "paths": [
    [
      {"x": 0, "y": 320},
      {"x": 256, "y": 320},
      {"x": 256, "y": 576},
      {"x": 640, "y": 576},
      {"x": 640, "y": 192},
      {"x": 1024, "y": 192},
      {"x": 1024, "y": 576},
      {"x": 1280, "y": 576}
    ]
  ],
  "layout": [
    [0, 1, 1, 0, 0, 1, 1, 0, 0, 0, 1, 1, 0, 0, 1, 1, 0, 0, 0, 0],
    [0, 1, 1, 0, 0, 1, 1, 0, 0, 0, 1, 1, 0, 0, 1, 1, 0, 0, 0, 0],
    [0, 0, 0, 3, 0, 0, 0, 0, 0, 0, 0, 0, 3, 0, 0, 0, 0, 0, 0, 0],
    [0, 1, 1, 3, 0, 1, 1, 0, 0, 0, 1, 1, 3, 0, 1, 1, 0, 0, 0, 0],
    [0, 1, 1, 3, 0, 1, 1, 0, 0, 3, 3, 3, 3, 0, 1, 1, 0, 0, 0, 0],
    [0, 0, 0, 3, 3, 3, 3, 3, 3, 3, 1, 1, 0, 0, 0, 0, 0, 0, 0, 0],
    [0, 1, 1, 0, 0, 1, 1, 0, 0, 0, 1, 1, 0, 0, 1, 1, 0, 0, 0, 0],
    [0, 1, 1, 0, 0, 1, 1, 0, 0, 0, 1, 1, 0, 0, 1, 1, 0, 0, 0, 0],
    [0, 0, 0, 0, 0, 0, 0, 3, 3, 3, 3, 3, 3, 3, 3, 3, 3, 3, 0, 0],
    [0, 1, 1, 0, 0, 1, 1, 0, 0, 0, 1, 1, 0, 0, 1, 1, 0, 0, 0, 0],
    [0, 1, 1, 0, 0, 1, 1, 0, 0, 0, 1, 1, 0, 0, 1, 1, 0, 0, 0, 0],
    [0, 0, 0, 0, 0, 0, 0, 0, 0, 0, 0, 0, 0, 0, 0, 0, 0, 0, 0, 0]
  ]
}
